#########################
#A$$$$$$$$$$$$$$$$$$$$$B#
#              #        #
#$$$$$$$$$$$$$ # $$$$$$$#
#              #        #
# $$$$$$$$$$$$###$$$$$$ #
#         $             #
#$$$$$$$$ $ $$$$$$$$$$$$#
#         $             #
# $$$$$$$$$$$#####$$$$$ #
#                       #
# $         ##$$$$$$$$$ #
# $$$$$$$$$##         $ #
#                       #
# $          $        $ #
# $$$$$$$$######$$$$$$$ #
# $          $        $ #
#                       #
# $         ###$$$$$  $ #
# $$$$$$           $  $ #
# $    $$$      $       #
#            #$$$$$$$$$ #
# $$$$$$$$$$    #$    $ #
#D    #$$$$$$$         C#
#########################
